Avancé
+---+---+---+---+
|   | C |   |   |
+---+---+---+---+
| F |   | C |   |
+---+---+---+---+
| T |   |   |   |
+---+---+---+---+
| Q |   |   |   |
+---+---+---+---+