Débutant
+---+---+---+---+
| T |   |   | T |
+---+---+---+---+
|   |   | P |   |
+---+---+---+---+
|   | C |   |   |
+---+---+---+---+
|   |   |   |   |
+---+---+---+---+