Intermédiaire
+---+---+---+---+
|   |   |   | C |
+---+---+---+---+
| Q |   |   |   |
+---+---+---+---+
| T |   |   | F |
+---+---+---+---+
| F |   | F |   |
+---+---+---+---+