Débutant
+---+---+---+---+
|   |   |   |   |
+---+---+---+---+
|   | F |   |   |
+---+---+---+---+
| P |   | T |   |
+---+---+---+---+
| C |   |   |   |
+---+---+---+---+