Avancé
+---+---+---+---+
|   | P |   |   |
+---+---+---+---+
|   | Q |   | T |
+---+---+---+---+
| F |   | C |   |
+---+---+---+---+
|   |   |   | P |
+---+---+---+---+