Débutant
+---+---+---+---+
|   |   | P |   |
+---+---+---+---+
|   |   | C |   |
+---+---+---+---+
| Q |   |   |   |
+---+---+---+---+
|   |   | F |   |
+---+---+---+---+