Intermédiaire
+---+---+---+---+
|   |   | C |   |
+---+---+---+---+
| Q |   | F |   |
+---+---+---+---+
|   |   |   |   |
+---+---+---+---+
| P | C |   |   |
+---+---+---+---+