Débutant
+---+---+---+---+
|   | C |   |   |
+---+---+---+---+
|   |   | F |   |
+---+---+---+---+
| T |   |   |   |
+---+---+---+---+
|   |   |   |   |
+---+---+---+---+