Débutant
+---+---+---+---+
|   | P |   | T |
+---+---+---+---+
|   |   |   |   |
+---+---+---+---+
| T |   | Q |   |
+---+---+---+---+
|   | F |   |   |
+---+---+---+---+