Expert
+---+---+---+---+
| C |   |   |   |
+---+---+---+---+
| F | P |   | F |
+---+---+---+---+
|   |   |   | C |
+---+---+---+---+
| T | T | P |   |
+---+---+---+---+