Expert
+---+---+---+---+
|   |   | T | P |
+---+---+---+---+
| C | F | T |   |
+---+---+---+---+
| F | P |   |   |
+---+---+---+---+
|   |   | C |   |
+---+---+---+---+