Débutant
+---+---+---+---+
| P |   | T | C |
+---+---+---+---+
|   | F | T | P |
+---+---+---+---+
| P |   | R | P |
+---+---+---+---+
| Q |   | Q | F |
+---+---+---+---+