Intermédiaire
+---+---+---+---+
| F |   | T | T |
+---+---+---+---+
|   | F | T | P |
+---+---+---+---+
| P |   |   |   |
+---+---+---+---+
| Q |   | Q | F |
+---+---+---+---+